CD86	GTCTTTGTCAGTGCA
CD274	GTTGTCCGACAATAC
TNFRSF14	TGATAGAAACAGACC
PVR	ATCACATCGTTGCCA
NECTIN2	AACCTTCCGTCTAAG
CD47	GCATTCTGTCACCTA
CD48	CTACGACGTAGAAGA
CD40	CTCAGATGGAGTATG
CD40LG	GCTAGATAGATGCAA
CD52	CTTTGTACGAGCAAA
CD3D	CTCATTGTAACTCCT
CD8A	GCGCAACTTGATGAT
NCAM1	TCCTTTCCTGATAGG
CD19	CTGGGCAATTACTCG
CD33	TAACTCAGGGCCTAT
ITGAX	TACGCCTATAACTTG
HLA-A	TATGCGAGGCTTATC
PTPRC.1	TCAATCCTTCCGCTT
IL3RA	CTTCACTCTGTCAGG
CD7	TGGATTCCCGGACTT
ITGA6	TTCCGAGGATGATCT
CCR4	AGCTTACCTGCACGA
CD4	TGTTCCCGCTCAACT
CD44	TGGCTTCAGGTCCTA
CD14	TCTCAGACCTCCGTA
FCGR3A	AAGTTCACTCTTTGC
IL2RA	TTTGTCCTGTACGCC
PTPRC.2	CTCCGAATCATGTTG
PDCD1	ACAGCGCCGTATTTA
TIGIT	TTGCTTACCGCCAGA
IgG1_mouse	GCCGGACGACATTAA
IgG2a_mouse	CTCCTACCTAAACTG
IgG2b_mouse	ATATGTATCACGCGA
IgG2b_rat	GATTCTTGACGACCT
MS4A1	TTCTGGGTCCCTAGA
NCR1	ACAATTTGAACAGCG
PECAM1	ACCTTTATGCCACGG
PDPN	GGTTACTCGTTGTGT
MCAM	CCTTGGATAACATCA
IGHM	TAGCGAGCCCGTATA
CD5	CATTAACGGGATGCC
CXCR3	GCGATGGTAGATTAT
CCR5	CCAAAGTAAGAGCCA
FCGR2A	GCTTCCGAATTACCG
CCR6	GATCCCTTTGTCACT
CXCR5	AATTCAACCGTCGCC
ITGAE	GACCTCATTGTGAAT
CD69	GTCTCTTGGCTTAAA
SELL	GTCCCTGCAACTTGA
KLRB1	GTACGCAGTCCTTCT
CTLA4	ATGGTTCACGTAATC
LAG3	CATTTGTCTGCCGGT
KLRG1	CTTATTTCCTGCCCT
CD27	GCACTCCTGCATGTA
LAMP1	CAGCCCACTGCAATA
FAS	CCAGCTCATTAGAGC
TNFRSF4	AACCCACCGTTGTTA
HLA-DRA.1	AATAGCGAGCAAGTA
CD1C	GAGCTACTTCACTCG
ITGAM	GACAAGTGATCTGCA
FCGR1A	AAGTATGCCCTACGA
THBD	GGATAACCGCGCTTT
KLRK1	CGTGTTTGTTCCTCA
CR1	ACTTCCGTCGATCTT
B3GAT1	AACTCCCTATGGAGG
BTLA	GTTATTGGACTAAGG
ICOS	CGCGCACCCATTAAA
ICOSLG	GTTAGTGTTAGCTTG
CD58	GTTCCTATGGACGAC
ENTPD1	TTACCTGGTATCCGT
CX3CR1	AGTATCGTCTCTGGG
CD24	AGATTCCTTCGTGTT
CR2	AACCTAGTAGTTCGG
ITGAL	TATATCCTTGTGAGC
CD79B	ATTCTTCAACCGAAG
CD244	TCGCTTGGATGGTAG
SIGLEC1	TACTCAGCGTGTTTG
ITGB7	TCCTTGGATGTACCG
TNFRSF13C	CGAAGTCGATCCGTA
GP1BB	TCCTAGTACCGAAGT
ICAM1	CTGATAGACTTGAGT
SELP	CCTTCCGTATCCCTT
IFNGR1	TGTGTATTCCCTTGT
TCRab	CGTAACGTAGAGCGA
IgG1_k_rat	ATCAGATGCCCTCAT
IgG1_l_rat	GGGAGCGATTCAACT
IgG2a_k_rat	AAGTCAGGTTCGTTT
IgG2c_k_rat	TCCAGGCTAGTCATT
IgG2c_k_hamster	CCTGTCATTAAGACT
CCR2	GAGTTCCCTTACCTG
IL2RB	TCATTTCCTCCGATT
TNFRSF13B	AGTGATGGAGCGAAC
FCER1A	CTCGTTTCCGTATCG
ITGA2B	ACGTTGTGGCCTTGT
TNFRSF9	CAGTAAGTTCGGGAC
SPN	GATTAACCAGCTCAT
CD163	GCTTCTCCTTCCTTA
CD83	CCACTCATTTCCGGT
ANPEP	TTTCAACGCCCTTTC
CD2	TACGATTTGTCAGGG
CD226	TCTCAGTGTTTGTGG
ITGB1	GTATTCCCTCAGTCA
CLEC4C	GAGATGTCCGAATTT
ITGA2	GCTTTCTTCAGTATG
ITGB3	AGGTTGGAGTAGACT
CD81	GTATCCTTCCTTGGC
CD55	GCTCATTACCCATTA
IGHD	CAGTCTCCGTAGAGT
ITGB2	TATTGGGACACTTCT
CD28	TGAGAACGACCCTAA
CD38	TGTACCCGCTTGTGA
IL7R	GTGTGTTGTCCTATG
PTPRC	TGCAATTACCCGGAT
CD22	GGGTTGTTGTCTTTG
TFRC	CCGTGTTCCTCATTA
DPP4	GGTGGCTAGATAATG
CSF1R	AATCACGGTCCTTGT
CD63	GAGATGTCTGCAACT
NRP1	GGACTAAGTTTCGTT
CD36	TTCTTTGCCTTGCCA
SIRPA	CGTGTTTAACTTGAG
CD72	CAGTCGTGGTAGATA
KIR2DL1	TATCAACCAACGCTT
CD93	GCGCTACTTCCTTGA
CD200	CACGTAGACCTTTGC
ITGA1	ACTGATGGACTCAGA
ITGA4	CCATTCAACTTCCGG
NT5E	CAGTTCCTCAGTTCG
CD9	GAGTCACCAATCTGC
TCRVa7.2	TACGAGCAGTATTCA
TCRVd2	TCAGTCAGATGGTAT
TREM1	TAGCCGTTTCCTTTG
LAIR1	ATTTCCATTCCCTGT
OLR1	ACCCTTTACCGAATA
KIR3DL1	GGACGCTTTCCTTGA
CD109	CACTTAACTCTGGGT
F3	CACTGCCGTCGATTA
SLAMF7	AGTATGCCATGTCTT
CD99	ACCCGTCCCTAAGAA
CLEC12A	CATTAGAGTCTGCCA
CD151	CTTACCTAGTCATTC
SLAMF6	AGTTTCCACTCAGGC
CLEC1B	TGCCAGTATCACGTA
KLRD1	CTTTCCGGTCCTACA
IGHE	GGATGTACCGCGTAT
SLAMF1	GTCATTGTATGTCTG
SELPLG	ATATGTCAGAGCACC
CD84	CTCCCTAGTTCCTTT
IGKC	AGCTCAGCCAGTATG
LILRB1	CCTTGTGAGGCTATG
FCER2	TCTGTATAACCGTCT
Ig_light_l	CAGCCAGTAAGTCAC
SIGLEC7	CTTAGCATTTCACTG
ADGRG1	GCCTAGTTTCCGTTT
CD82	TCCCACTTCCGCTTT
KLRF1	TATAGTTCCTCTGTG
CSF2RB	CTGCATGAGACCAAA
CD74	CTGTAGCATTTCCCT
CSF2RA	ATGGACAGTTCGTGT
CD37	ACAGTCACTGGGCAA
CD101	CTACTTCCCTGTCAA
HLA-DRA.2	AGCTACGAGCAGTAG
C5AR1	GCCGCATGAGAAACA
